111111111111
1000CPE00001
100000000111
111111111111