111111111
100000001
100CEP001
100000001
111111111