111111111111
1000CPE0PPP1
1PPPP0PPP111
111111111111